14
3,7,7,7,6,0,3,5,7,7,7,5,5,4
10,10,10,9,15,5,14,0,11,13,14,3,5,4
10,10,10,0,10,0,11,7,14,0,10,10,3,4
11,15,15,7,13,7,14,10,11,7,15,15,14,0
8,10,11,14,0,11,14,10,11,14,10,10,10,0
1,12,11,13,5,13,12,8,9,12,8,10,11,6
1,5,15,5,5,4,3,6,1,5,5,15,15,14
1,5,12,1,5,4,9,15,5,5,5,15,15,14
1,7,7,5,5,4,2,11,7,7,7,13,14,10
3,13,14,1,5,4,10,11,14,10,10,0,10,10
10,0,11,5,5,4,11,15,12,10,11,5,12,8
9,5,14,3,7,7,15,15,7,15,15,5,5,4
1,5,15,15,13,13,13,15,15,15,15,7,7,6
1,5,13,13,5,5,4,8,8,8,8,8,8,8
